0
0
0
0
0
0
0
000000000000
000000000000000000000000000000000000000000000000000000000000000000000000000080000000000000000080000000000000000000001
000000000001000000000000000000000000000000000000000000000000000000000008000222200011110000100111110000000000000000001
000000000011000000000000000001112022002220011000000000000100000000000011000000000000000000000000000000000000000000001
000000008111000000000000000000000000000000000000000222200000000000000010000000000000000000000001100000000000000000001
000000001111000000001000000000000000000000000000001200000000000000001000000000000000000000000021000000000000000000001
000000011111090999011000001220000000000000000000008090008809090909090909090909999090998000000120000000007000000000001
11111111111111111111111111111111111111111111111111111111111111111111111111111111111111111111111111111111111111111111111111111111111111111111111111111111111111111111111111111111111111111111111111111111111111111
11111111111111111111111111111111111111111111111111111111111111111111111111111111111111111111111111111111111111111111111111111111111111111111111111111111111111111111111111111111111111111111111111111111111111111