0
0
0
0
0
00000000000F
000000000000
00000000000005
000000000005000500000000000000000000000005500550000000000000000000000000000080500005500000000085050000000000000000001
000500000001000005000000000000055005550000000000000000000000000000000008000222200011110000100111110000000000000000001
000500000011000000055000000001112022002220011000000000000100005500000011000000000000000000000000000000000000000000001
000S5000811100S050000000000000000000000000000000000222200000555500000010000000000000000000000001100000500000000000001
005000001111050005001000000000000000000000000000001205500000000000001000000000000000000000000021000005550000000000001
000040011111090999011000001220000000000000000000008090008809090909090909090909999090998000000120000000507000000000001
11111111111111111111111111111111111111111111111111111111111111111111111111111111111111111111111111111111111111111111111111111111111111111111111111111111111111111111111111111111111111111111111111111111111111111
11111111111111111111111111111111111111111111111111111111111111111111111111111111111111111111111111111111111111111111111111111111111111111111111111111111111111111111111111111111111111111111111111111111111111111